AnimCaptain=Анимация капитанов:
AnimGov=Анимация правительства:
AnimHangar=Анимация ангара:
AnimItem=Анимация оборудования:
AnimShip=Анимация кораблей:
AnimShipFull=Полная
AnimShipSmall=Сокращенная
AnimStar=Анимация звезд:
BGImage=Фон:
Brightness=Яркость:
CacheSize=Размер кэша (Мб):
Cancel=Отменить
CircleAction=Область вне радара:
CircleActionHide=Затененная
CircleActionNormal=Нормальная
Comet=Кометы:
CometLarge=Много
CometOff=Отключены
CometSmall=Мало
Contrast=Контрастность:
CountFilmSave=Количество дней в фильме:
GGraph=Графика
GMain=Общее
GSound=Музыка
HelpButCancel=Отменить
HelpButMax=Высокое качество
HelpButMiddle=Оптимальное качество
HelpButMin=Низкое качество
HelpButOk=Принять
Lang=Язык:
Music=Музыка:
MusicInSpace=Музыка в космосе:
MusicVolume=Громкость музыки:
No=Нет
Ok=Применить
Resolution=Разрешение:
Resolution1024=1024x768
Resolution800=800x600
ScrollSpeed=Скорость скроллинга:
ShowFPS=FPS:
Sound=Звуки:
SoundInSpace=Звуки в космосе:
SoundVolume=Громкость звуков:
SpaceImage=Туманности:
SputnikShow=Спутники:
TailAll=У всех кораблей
TailOff=Отключены
TailPlayer=У игрока
Tails=Шлейфы:
Wind=Космический ветер:
WindFull=Сильный
WindOff=Отключен
WindSmall=Слабый
Yes=Да
