AlreadyHavePartner=Извини, но мой партнер рейнджер <Partner>. Ну, не в том смысле, что он мой партнер, просто я на него работаю!
AlreadyHavePartner1=Ты опоздал, приятель, меня уже нанял рейнджер <Partner>. И меня работа под его командованием вполне устраивает.
AnswerLiderBreak=Я заплатил тебе, а ты нарушила наш договор. Надо бы тебя проучить!
AnswerLiderRiot=Да ты здесь особо и не нужна. Только проблемы создаешь!
AnswerLiderRiot1=От вас, девушек, одни проблемы! Проваливай, мне не нужен такой работник.
AnswerLiderTheEnd=Эх, жаль, ты не раз меня выручала в трудную минуту. Сейчас посмотрю на свои финансы и, возможно, продлю наш контракт.
AnswerLiderTheEnd1=Да, жаль терять такую лихую красотку, как ты. Сейчас прикину, сколько у меня денег, и составим новый контракт.
AnswerLiderTheEndLowLeadership=Ну и дела. Я рассчитывал на твою помощь. Что ж, очень жаль. Пока.
AnswerLiderTheEndLowLeadership1=Могла бы и доработать контракт... ну да ладно, удачи тебе на просторах космоса.
ComputerAgreeFlyToMe=Оки-доки, босс! Я следую за тобой!
ComputerAgreeFlyToStar=Так точно, босс. Держу курс на систему <Star>. Надеюсь, там найдется что-нибудь вкусненькое...
ComputerAgreeFlyToStar=Только ты предупреждай заранее, если наши планы изменятся.
ComputerAgreeLandingToObject=Слушаюсь и повинуюсь, хи-хи! Если я верно поняла, мы совершаем посадку на <ObjectName>.
ComputerAgreeLandingToObject=Курс проложен, все системы работают нормально. Я лечууу!..
ComputerDismissBad=Что?! Я на него пашу как проклятая, а в ответ никакой благодарности! Ууу, сейчас я тебе покажу, кто тут кому надоел!
ComputerDismissGood=Ну, ладно, <Player>, удачи тебе. Может еще увидимся.
ComputerDismissNo=Ну и шуточки у тебя, <Player>. Дурак.
ComputerDismissQuestion=В чем дело, <Player>? Разве я плохо выполняю наши контрактные обязательства?
ComputerDropCargoNo=Да нет у меня ничего лишнего в трюме. Если не веришь, воспользуйся сканером!
ComputerDropCargoNo1=Босс! Я бы выкинула весь свой груз, но ничего нет. Лечу налегке. Имеешь еще что-то сказать?
ComputerDropCargoOk=Я, конечно, обязана подчиняться, и выкину груз, но имей в виду, что это больше похоже на грабеж, чем на партнерские отношения.
ComputerDropCargoOk1=Ну ты и нахал, <Player>. Я служу тебе верой и правдой, а ты этим пользуешься и отнимаешь у меня честно нажитое добро. Так дела не делаются.
ComputerDropCargoOk2=Хорошо, сейчас выкину груз. Но я не могу сказать, что мне нравится твоя идея. Даже скажу, что она мне не нравится.
ComputerInFear=Эм, прости, но мне сейчас не до работы. Нужно срочно сматываться, пока хвост не подпалили.
ComputerInFear1=Да ты смеешься что ли?! Смотри, что вокруг творится! Мне нужно срочно залатать дыры, поговорим позже!
ComputerSayNo=За жалкие <Money> cr я не стану на тебя работать. Мне нужен нормальный контракт и хорошие условия работы.
ComputerSayNo1=Нет, спасибо, я себя не в помойке нашла, чтобы горбатиться на тебя за <Money> cr.
ComputerSayOk=За <Money> cr я готова работать на тебя <Month> мес. Если считаешь это слишком маленьким сроком, то можешь удвоить сумму.
ComputerSayOk1=Что ж, тебе повезло, что я сейчас ничем не занята. За <Money> cr я могу поработать на тебя <Month> месяцев. На это время я доверяю тебе свою жизнь, постарайся меня не угробить.
ComputerSayOk2=За <Money> cr и ежедневное лицезрение твоей симпатичной мордашки я могу поработать на тебя <Month> месяцев. Но ты учти, что я девушка, не посылай меня воевать в самое пекло.
FinancesCheck=Как твое финансовое положение?
FinancesConfirmed=Ясно
FinancesGotGift=Спасибо, теперь на моем счету <Money> cr.
FinancesOfferGift=Дать денег напарнику
FinancesReport=<Player>, у меня на счету <Money> cr.
FinancesSendGift=Возьми <Money> cr.
FinancesWaitForGift=Итак, <Player>, сколько ты готов мне подкинуть?
FlyToMe=Хватит марафет наводить, лети за мной, дело есть
FlyToMe1=Лети скорее за мной, деньги будем зарабатывать
FlyToStar=Совершаем гиперпрыжок в систему <Star>
ILeader=Я кошка, которая гуляет сама по себе. Никто не смеет мне приказывать, мяу. ^_^
ILeader1=Меня никто не нанимает, это я сама нанимаю других! Тебе можно у меня поучиться.
IsOrderForAll=Это приказ по группе или лично мне?
LandingToObject=Совершаем посадку на <ObjectName>
MateBreak=Я была твоим партнером, но ты постоянно совершаешь действия, противоречащие моим принципам. Поэтому я отказываюсь от партнерства.
MateBreak1=Мне совсем не нравится быть твоим партнером. Ты не такой, каким показался мне вначале. Прощай.
MateRiot=Всё, с меня хватит! Больше я не намерена терпеть издевательства над собой. Наведи сначала порядок у себя в команде, а потом может быть и поговорим о партнерстве.
MateTheEnd=Слушай, срок нашего контракта закончился, и теперь я вольна делать все, что захочу.
MateTheEnd1=Имей в виду, срок моего контракта подошел к концу. Я честно выполнила свои обязательства.
MateTheEndLowLeadership=Эй, <Player>, что это с твоими навыками лидерства? Раньше мне казалось, что ты более крут. Неужели зрение меня подвело... в любом случае, я досрочно разрываю наш контракт. Увидимся.
MateTheEndLowLeadership1=У меня для тебя две новости, <Player>, хорошая и плохая. Плохая заключается в том, что я больше не буду на тебя работать, потому что для меня позор летать под началом рейнджера со столь низким уровнем лидерства. А хорошая новость в том, что как только ты поднаберешься опыта по части командной игры - я снова поработаю с тобой, если ты захочешь.
NeedLeadership=Ты не похож на лидера, <Ranger>. У тебя такая физиономия, будто ты неделю назад из деревни прилетел.
NeedLeadership=Советую развить в себе навык лидерства, а то пока тебе просто бессмысленно заниматься поиском партнеров.
NeedLeadership1=Нет-нет, я буду работать только с крутыми парнями, имена которых гремят на всю галактику. Да и на лицо ты совсем не красавчик.
Ok=О'кей, я буду служить тебе <Month> мес. Обязуюсь всегда быть рядом и приходить на помощь в минуты опасности.
Ok=Только свистни, и мои крутые стволы в твоем распоряжении, <Ranger>.
Ok1=По рукам. Мой корабль в твоем распоряжении на <Month> мес.
Ok1=Я буду душой и телом с тобой, <Ranger>, в минуты горя и радости, пока смерть не разлучит нас. Но руки не распускай, а то я их тебе укорочу и даже не посмотрю, что ты мой босс!
OrderForAll=Это приказ всем! С каждым отдельно я общаться не намерен.
OrderForYou=Тебе, персонально. Конец связи.
PlayerDismissBad=Надоела ты мне своими выходками, видеть тебя не могу. Проваливай.
PlayerDismissGood=Ты отлично работала на меня, но теперь тебе оставаться со мной будет опасно.
PlayerDismissNo=Ха-ха! Я пошутил!
PlayerDismissSend=Пора нам с тобой расстаться
PlayerLess=Установить сумму в 2 раза меньше
PlayerMore=Удвоить сумму
PlayerOk=Договорились
PlayerSend=Иди под мое командование, <Ranger>
PlayerSend1=Выходи за меня...ой, в смысле, иди под мое командование, <Ranger>!
PlayerSend2=<Ranger>, не желаешь поработать под началом великого рейнджера, меня?
PlayerSendDropCargo=Мы летим налегке. Тебе пора избавиться от лишнего груза.
PlayerSendDropCargo1=Подруга, давай выкидывай лишний груз. Я помогу тебе с перевозкой.
Send=Я готова выложить <Money> cr за то, чтобы ты стал моим партнером
Send1=Плачу <Money> cr, и ты идешь на меня работать
SmallMoney=Я отказываюсь. Мои услуги и время стоят гораздо больше...
SmallMoney1=Что? Ты хочешь купить меня за эти жалкие копейки?
SmallMoney2=Нет, я не буду работать за такие гроши!
Suspect=Я тебе не настолько доверяю, чтобы рассматривать предложение о партнерстве.
Suspect1=Ты слишком подозрительный тип. Не буду на тебя работать.
Suspect2=У тебя физиономия, как у серийного убийцы и имя такое же. Не буду я на тебя работать.
YouNeedInMoreRank=Ты смеешься, <Ranger>? Вообще-то мое звание гораздо выше твоего. Для меня будет позором работать под твоим командованием.
