HelpFind=Поиск
HelpNews=Новости
HelpSearch=Искать
HoleName=Черная дыра
HoleText=Через дыру можно попасть в другие части галактики.
HoleText=Объект не изучен и потому представляет опасность для исследователей
IPEco=Экономика:
IPGov=Строй:
IPOwner=Раса:
IPPop=Население:
IPRel=Отношение:
ISDef=Защита:
ISRel=Отношение:
ISSize=Структура:
ISSpeed=Скорость:
ISType=Тип:
ISWin=Победа:
InPrison=Сидит в тюрьме
NotFound=Объектов, отвечающих данному запросу, не найдено
NotMoney=Стоимость запроса <Money> cr.
NotMoney=У вас нет этой суммы на счету
ObjOutOfRange=Объект находится вне зоны действия радара
ObjectFoundEnd=Итого найдено объектов: <Count>
ObjectFoundStart=Результаты поиска ближайших <Count> объектов, удовлетворяющих запросу
Partner=-партнёр-
Planet=Планета: <PlanetName>
SearchInfo=База данных сети информационных центров к вашим услугам. Каждый ответ будет стоить вам <Money> cr.<br>Принимаются любые сочетания букв, вплоть до одной буквы от названия корабля, станции или планеты. Искать можно даже оборудование, продаваемое в магазинах.<br>Примечание: Компьютер выдаст лишь <Count> ближайших объектов, удовлетворяющих вашему запросу.
SearchStr=Поиск в базе данных:
Sector=Cектор: <SectorName>
Star=Система: <StarName>
СontainerName=Контейнер
