AddInfo=Дополнительная информация
Drop=выбросить
ForsageActivate=Форсаж активирован. Износ двигателя в полете будет максимальным.
FromStorageItem=Взять со склада <Name>
Fuel=заправка<br><Money> cr
FullRepare=Полный ремонт
FullRepareNo=не требуется
HullInHoldError=Корпус слишком большой, вы не можете положить его в трюм.
IDef=Защита
IEmpty=Свободно
IMass=Масса
ISpeed=Скорость
LActivate=Активировать
LAdd=Дополнительное оборудование
LDrop=Выбросить
LGate=Шлюз
LHold=Трюм
LInfo1=Система
LInfo2=отслеживания
LMove1=Система
LMove2=движения
LSC=Сервисный центр
LStorage=Склад
LWeapon=Вооружение
Missile=зарядка<br><Money> cr
NotLicenseForRepair=Извините, <Player>, но у нас нет лицензии на починку нестандартного оборудования. Обратитесь на научную базу или к пиратам.
NotUseTransmitter=Трансфакторный маяк разряжен. Срок до накопления минимального заряда: <Count> дн.
Points=Новый опыт
Repair=починка<br><Money> cr
RepairAll=<Money> cr
RepairMsgNeedMoney=Не хватает <NeedMoney> cr
RepairMsgOk=Теперь <Name><br>в полном порядке!
Sell=продажа<br><Money> cr
SellItem=Продать <Name>
SellOrBuyInPlanetAndBadRelations=<Player>, на планете <Planet> вы являетесь нежелательным гостем. Загляните в здание правительства для выяснения отношений.
Skills=Навыки
Storage=Склад
StorageInfo=StorageInfo\StorageInfo.txt ^{
}
StorageItem=Сдать на склад <Name>
ThrowEngineError=Нельзя выбрасывать двигатель, не установив взамен другой!<br>Вы не сможете летать!
ThrowFuelTanksError=Нельзя выбрасывать топливный бак, не установив взамен другой!<br>Вы не сможете летать!
ThrowItem=Выбросить <Name>
Use=использовать
UseTransmitter=Сообщение о наличии неизученного материала в системе <Star> отправлено. Исследователи прибудут через <clr>10<clrEnd> дней.
