ABChangeEq=Смена оборудования в ЧД
ABChangeEqNo=Запрещена
ABChangeEqYes=Разрешена
ABDamageMod=Урон противников в ЧД
ABDropValueMod=Качество оборудования, выпадающего<br>из противников в ЧД
ABHitpointsMod=Выносливость противников в ЧД
ABattleRoyale=Противники в ЧД
ABattleRoyaleNo=Действуют заодно
ABattleRoyaleYes=Враждуют между собой
AITolerateJunk=Количество предметов в системе, после<br>которого пилоты начинают их расстреливать
AIUseShops=Компьютерные игроки<br>получают оборудование
AIUseShopsNo=По собственным каналам
AIUseShopsYes=Покупают в магазине
AkrinMod=Количество акриновых вещей в магазинах
AsteroidMod=Количество астероидов
CoalAggro=Активность коалиции
DropValueMod=Максимальная стоимость<br>выпадающих предметов
DuplicateArts=Использование нескольких однотипных артефактов
DuplicateArtsNo=Запрещено
DuplicateArtsYes=Разрешено
EqKnowledge=Использование и ремонт<br>оборудования
EqKnowledgeRestricted=Ограничены техническим уровнем
EqKnowledgeUnRestricted=Без ограничений
ExtraInventions=Бонус к стартовым технологиям
ExtraRangers=Количество дополнительных рейнджеров
HullGrowth=Размер корпусов в магазине
HullGrowthNormal=Растет с увеличением корпуса игрока
HullGrowthSlow=Медленно растет с увеличением корпуса игрока
HullGrowthTechOnly=Ограничен техническим уровнем
KlingAggro=Агрессивность доминаторов
KlingRacialWeapons=Особое вооружение, разработанное другими сериями,<br>рядовым доминаторам
KlingRacialWeaponsNo=Доступно
KlingRacialWeaponsYes=Не доступно
KlingSpawn=Темп воспроизводства доминаторов
KlingStrength=Оснащение доминаторов
MaxRangeMissiles=Управляемые компьютером корабли <br>стреляют ракетами и торпедами
MaxRangeMissilesNo=Со средней дистанции
MaxRangeMissilesYes=С максимальной дистанции
MissileBonuses=Бонусы к урону ракетного оружия
MissileBonusesNotSplit=Применяются к каждой ракете залпа
MissileBonusesSplit=Разделяются на ракеты в залпе
NodeDropMod=Количество нодов, выпадающих из доминаторов
OldHyper=Сражения с гиперпиратами при перелетах<br>между системами
OldHyperNo=Выключены
OldHyperYes=Включены
PirateAggro=Агрессивность пиратов
PirateNodes=Продажа нодов на пиратских станциях
PirateNodesNo=Выключена
PirateNodesYes=Включена
PlanetsAg=Относительное содержание в галактике<br>аграрных планет
PlanetsIn=Относительное содержание в галактике<br>индустриальных планет
PlanetsMi=Относительное содержание в галактике<br>планет со смешанной экономикой
Rnd=Результат случайных событий
RndChaotic=Меняется при загрузке сохранения
RndDetermined=Не меняется при загрузке сохранения
RuinsPosition=Постройка станций
RuinsPositionNear=Близко к центру
RuinsPositionNormal=В произвольном месте системы
RuinsTargetting=Вдали от игрока станции
RuinsTargettingFull=Сражаются как обычно
RuinsTargettingLimited=Пропускают выстрелы
RuinsUseShop=Космические станции могут<br>получать новое оборудование
RuinsUseShopNo=Только с помощью игрока
RuinsUseShopYes=Из собственного магазина
SmallStartingHulls=Корпуса больших размеров кораблям<br>коалиции и пиратам доступны
SmallStartingHullsNo=Изначально
SmallStartingHullsYes=По мере развития технологий
SpecialShips=Старые уникальные корпуса (Болид, Убийца, Скала)
SpecialShipsNo=В игре отсутствуют
SpecialShipsYes=В игре присутствуют
SpeedCalc=Формула скорости корабля
SpeedCalcLinear=Линейная
SpeedCalcNonLinear=Нелинейная
StartCenter=Расположение стартовой системы<br>игрока
StartCenterNo=В дальнем углу
StartCenterYes=В центре
SunDamageMod=Урон от звезд
ZeroStartExp=Пираты, мирные и военные корабли<br>появляются
ZeroStartExpNo=С некоторым стартовым опытом
ZeroStartExpYes=Без стартового опыта
