MapTerron=data\Ruins\MapTerron.gi
MapKeller=data\Ruins\MapKeller.gi
MapBlazer=data\Ruins\MapBlazer.gi

MapWB=data\Ruins\MapWB.gi
MapPB=data\Ruins\MapPB.gi
MapSB=data\Ruins\MapSB.gi
MapBK=data\Ruins\MapBK.gi
MapMC=data\Ruins\MapMC.gi
MapRC=data\Ruins\MapRC.gi

Map=data\Ruins\map.gi

RC=data\Ruins\RC.gai
PB=data\Ruins\PB.gai
WB=data\Ruins\WB.gai
WBTo=data\Ruins\WBTo.gai
WBFrom=data\Ruins\WBFrom.gai
SB=data\Ruins\SB.gai
BK=data\Ruins\BK.gai
MC=data\Ruins\MC.gai

RCi=data\Ruins\RC.gi
PBi=data\Ruins\PB.gi
WBi=data\Ruins\WB.gi
SBi=data\Ruins\SB.gi
BKi=data\Ruins\BK.gi
MCi=data\Ruins\MC.gi

Blazer=data\Ruins\Blazer.gai
Blazeri=data\Ruins\Blazer.gi

Keller=data\Ruins\Keller.gai
Kelleri=data\Ruins\Keller.gi

Keller_P1=data\Ruins\Keller_P1.gai
Keller_P2=data\Ruins\Keller_P2.gai
Keller_P3=data\Ruins\Keller_P3.gai
Keller_P4=data\Ruins\Keller_P4.gai

Keller_Out=data\Ruins\Keller_Out.gai

Terron=data\Ruins\Terron.gai
Terroni=data\Ruins\Terron.gi
