ActionDoubleClick=Разрешить действия<br>на двойной клик мышки:
AnimCaptain=Анимация капитанов:
AnimChangeForm=Анимированный переход<br>между экранами:
AnimGov=Анимация правительства:
AnimGovFull=Полная
AnimGovHalf=Сокращенная
AnimGovOff=Отключена
AnimHangar=Анимация ангара:
AnimItem=Анимация оборудования:
AnimMainFon=Анимированный задний<br>план на главном экране:
AnimMenuShip=Анимация кораблей<br>в главном меню:
AnimShip=Анимация кораблей:
AnimShipFull=Полная
AnimShipSmall=Сокращенная
AnimStar=Анимация звезд:
Auto=Произведена автоматическая настройка конфигурации.
AutoMax=Произведена настройка конфигурации для игры при максимальном качестве.
AutoMiddle=Произведена настройка конфигурации для игры при оптимальном качестве.
AutoMin=Произведена настройка конфигурации для игры при минимальном качестве.
BGImage=Космические фоны:
BackgroundBlur=Размывать задний план:
BackgroundGrayscale=Задний план в оттенках серого:
BackgroundShade=Затенять задний план:
BeginCalcNextTurn=Начало расчета<br>следующего дня: <Value>%
Brightness=Яркость: <Value>
CacheSize=Размер кэша (Мб): <Value>
Cancel=Отменить
Caption=Настройки
ChangeAutoPilot=Автопилот в черных<br>дырах (секунды): <Value>
CircleAction=Область вне радара:
CircleActionHide=Затененная
CircleActionNormal=Нормальная
ClickAutoCloseForm=Автозакрытие формы при клике<br>за ее пределами
Comet=Кометы:
CometLarge=Много
CometOff=Отключены
CometSmall=Мало
Contrast=Контрастность: <Value>
CountFilmSave=История полетов<br>(дни): <Value>
DefaulrOrderWar=Автобой
DefaultOrder=Приказ<br>по умолчанию:
DefaultOrderAuto=Интеллектуальный
DefaultOrderFar=Преследовать
DefaultOrderNear=Приближаться
DisableAutoPilot=Отключить автопилот<br>в черных дырах
DynamicTipsPos=Динамическое расположение подсказок:
FilmSpeed=Длительность хода<br>в космосе:
FilmSpeed0=Медленно
FilmSpeed1=Нормально
FilmSpeed2=Быстро
FilmSpeed3=Очень Быстро
FontDialog=Шрифт в диалогах:
FontGalaxy=Шрифт на гала-карте:
FontGalaxyMini=Минимальный
FontGalaxyNormal=Обычный
FontGalaxyNormalBold=Обычный жирный
FontGalaxyRanger=Моноширинный
FontGalaxySmall=Маленький
FontGalaxySmallBold=Маленький жирный
FontQuest=Шрифт в квестах:
FontSizeBig=Крупный
FontSizeLarge=Огромный
FontSizeMid=Средний
FontSizeNormalSmooth=Маленький сглаженный
FontSmooth=Сглаживание маленьких шрифтов:
ForsageTurnOff=Авто-отключение<br>форсажа: <Text>
ForsageTurnOffAlways=каждый ход.
ForsageTurnOffNever=никогда.
ForsageTurnOffStep=при износе <Value>%.
GGraph=Графика
GMain=Общее
GMod=Моды
GSound=Музыка
HardwareRender=Аппаратный рендеринг 2D-режима:
HelpAuto=Авто
HelpButAuto=Автоматически
HelpButCancel=Отменить
HelpButMax=Высокое качество
HelpButMiddle=Оптимальное качество
HelpButMin=Низкое качество
HelpButOk=Принять
Intro=Проигрывать заставки:
Lang=Язык:
MaxPlayerNews=Количество новостей<br>в журнале: <Value>
MaxSearchResult=Количество результатов<br>поиска в ЦР: <Value>
ModePlanet=Планетарные бои
ModeSpace=Космос
MultiThread=Включить поддержку многоядерности:<br>Необходим перезапуск игры!
Music=Музыка:
MusicInHyper=Музыка в гиперпространстве:
MusicInPlanet=Музыка на планетах<br>и базах:
MusicInSpace=Музыка в космосе:
MusicVolume=Громкость<br>музыки: <Value>
No=Нет
Ok=Применить
PlanetAtm=Атмосфера у планет:
PlanetClouds=Облака у планет:
QuickSaveSlots=Дополнительные слоты под<br>быстрое сохранение: <Value>
RenderMode=Режим рендеринга на<br>неподдерживаемых<br>разрешениях экрана:
RenderMode1=Масштабирование
RenderMode2=Прокрутка
Resolution=Разрешение:
RightClickOnShip=Правый клик мышки<br>по кораблю:
RightClickOnShipChangeOrder=Менять приказ
RightClickOnShipScaner=Сканирование
RightClickOnShipTalk=Разговор
RobotAnisotropy=Анизотропная<br>фильтрация: <Value>
RobotColorDepth=Кол-во цветов:
RobotColorDepth16=16 бит на пиксель
RobotColorDepth32=32 бит на пиксель
RobotFSAA=Полноэкранное<br>сглаживание: <Value>
RobotLandTexturesGloss=Металл на земле:
RobotMaxDistance=Дальность видимости: <Value>
RobotMusic=Музыка:
RobotObjTexturesGloss=Металл на объектах:
RobotRefresh=Частота обновления:
RobotRefreshDefault=По умолчанию
RobotRefreshMax=Максимальная
RobotRobotShadow=Стенсильные тени от роботов:
RobotRobotShadowOff=Выключены
RobotRobotShadowStencil=Включены
RobotSelectEx=Рамка выделения объектов:
RobotSelectExNormal=Обычная
RobotSelectExSpecial=Альтернативная
RobotShowProjShadows=Проекционные тени:
RobotShowProjShadowsOff=Выключены
RobotShowProjShadowsOn=Включены
RobotShowStencilShadows=Стенсильные тени:
RobotShowStencilShadowsOff=Выключены
RobotShowStencilShadowsOn=Включены
RobotSky=Небо:
RobotSkyGood=Высокое качество
RobotSkyLow=Низкое качество
RobotSkyOff=Отключено
RobotSoftwareCursor=Поддержка курсора:
RobotSoftwareCursorHardware=Аппаратная
RobotSoftwareCursorSoftware=Программная
RobotSound=Звуки:
ScreenShotQuality=Качество скриншота<br>в формате JPG: <Value>
ScreenShotType=Тип скриншотов:
ScrollSense=Чувствительность границ<br>скроллинга: <Value>
ScrollSpeed=Скорость<br>скроллинга: <Value>
ShotBMP=BMP
ShotJPG=JPG
ShotPNG=PNG
ShowFPS=FPS:
SimpleCalc=Упрощённый расчёт галактики:
SingleCoreWarning=Внимание! В вашем компьютере установлен одноядерный процессор.<br>Включение некоторых опций, в особенности - аппаратного рендера картинки, могут существенно замедлить скорость работы игры.
SkipGiper=Отключить аркадный<br>режим:
SoftwareCursor=Поддержка курсора:
SoftwareCursorHardware=Аппаратная
SoftwareCursorSoftware=Программная
Sound=Звуки:
SoundInSpace=Звуки в космосе:
SoundVolume=Громкость<br>звуков: <Value>
SpaceImage=Туманности:
SputnikShow=Спутники:
TailAll=У всех кораблей
TailOff=Отключены
TailPlayer=У игрока
Tails=Шлейфы:
TurnSaveStep=Пошаговые сохранения<br><Text>.
TurnSaveStep1=каждый ход
TurnSaveStep2=каждые <Value> хода
TurnSaveStep3=каждые <Value> ходов
TurnSaveStepNever=никогда
UseTablesForGov=Использовать столы в правительстве:
VSync=Вертикальная синхронизация:
Video=Проигрывать фильмы:
ViewFollowShip=Автоцентрирование камеры<br>на корабль:
ViewPathLength=Отображать длину пути
WarningBetaDemo=В данной урезанной версии планетарные бои не поддерживаются
WarningDriverOld=Требуется более новый драйвер для видеокарты.
WarningMod=Внимание! Использование модов приравнивается к читерству! Рекорды, сделанные с модами, будут помещаться в читерскую таблицу.
WarningNoDX9=Для планетарных боев необходим DirectX не ниже версии 9.0b, у вас установлена более ранняя версия!
WarningNoInstall=При инсталляции игры планетарные бои не были установлены!
WarningVideoUnsupported=Ваша видеокарта не поддерживается.
Wind=Космический ветер:
WindFull=Сильный
WindOff=Отключен
WindSmall=Слабый
Window=Оконный режим
Yes=Да
