AlreadyHavePartner=Извини, но мой партнер рейнджер <Partner>.
AlreadyHavePartner1=Ты опоздал, приятель, меня уже нанял рейнджер <Partner>.
AnswerLiderBreak=Я заплатил тебе, а ты нарушил наш договор. Надо бы тебя проучить!
AnswerLiderRiot=Да ты здесь особо и не нужен. Только проблемы создаешь!
AnswerLiderTheEnd=Эх, жаль, ты не раз меня выручал в трудную минуту. Сейчас посмотрю на свои финансы и, возможно, продлю наш контракт.
AnswerLiderTheEnd1=Да, жаль терять такого лихого парня, как ты. Сейчас прикину, сколько у меня денег, и составим новый контракт.
AnswerLiderTheEndLowLeadership=Очень жаль. Ну тогда бывай, удачи тебе.
AnswerLiderTheEndLowLeadership1=Эх, а я как раз хотел повоевать с тобой крылом к крылу, напарник. Ну ладно, тогда в следующий раз.
ComputerAgreeFlyToMe=Слушаюсь, босс! Я буду следовать за тобой, куда бы ты ни направился.
ComputerAgreeFlyToStar=Слушаюсь, командир. Держу курс на систему <Star>.
ComputerAgreeFlyToStar=Прошу сообщить мне заранее, если наши планы изменятся.
ComputerAgreeLandingToObject=Слушаюсь, босс! Если я верно понял, мы совершаем посадку на <ObjectName>.
ComputerAgreeLandingToObject=Курс проложен, все системы работают нормально.
ComputerDismissBad=Что? Я на него пашу как раб, а в ответ никакой благодарности! Сейчас я тебе покажу, кто тут кому надоел!
ComputerDismissGood=Ну, ладно, <Player>, удачи тебе. Может еще увидимся.
ComputerDismissNo=Ну и шуточки у тебя, <Player>.
ComputerDismissQuestion=В чем дело, <Player>? Разве я плохо тебе служу?
ComputerDropCargoNo=Да нет у меня ничего лишнего в трюме. Если не веришь, просканируй меня!
ComputerDropCargoNo1=Босс! Я бы выкинул весь свой груз, но ничего нет. Лечу налегке. Слушаю твои указания.
ComputerDropCargoOk=Я, конечно, обязан подчиняться, и выкину груз, но это больше похоже на грабеж, чем на партнерские отношения.
ComputerDropCargoOk1=Сейчас я избавлюсь от своего груза. Но замечу, что ты просто бессовестный тип, <Player>! Я служу тебе верой и правдой, а ты этим пользуешься.
ComputerDropCargoOk2=Хорошо, сейчас выкину груз. Но я не могу сказать, что мне нравится твоя идея.
ComputerInFear=Я извиняюсь, босс, но в данное время я не могу рассматривать никакие предложения. Поговорим позже, в более мирной обстановке. Сейчас мне надо сматываться.
ComputerSayNo=За жалкие <Money> cr я не стану на тебя работать. Мне нужен нормальный контракт и хорошие условия работы.
ComputerSayOk=Ну, что ж, за <Money> cr я готов работать на тебя <Month> мес. Если считаешь это слишком маленьким сроком, то можешь удвоить сумму.
FinancesCheck=Как твое финансовое положение?
FinancesConfirmed=Ясно
FinancesGotGift=Спасибо, теперь на моем счету <Money> cr.
FinancesOfferGift=Дать денег напарнику
FinancesReport=<Player>, у меня на счету <Money> cr.
FinancesSendGift=Возьми <Money> cr.
FinancesWaitForGift=Итак, <Player>, сколько ты готов мне подкинуть?
FlyToMe=Хватит дурака валять, лети за мной
FlyToMe1=Немедленно следуй за мной
FlyToStar=Совершаем гиперпрыжок в систему <Star>
ILeader=Я по своей природе лидер, и никогда не позволю, чтобы мной помыкали. Это другие пусть летают рядом со мной и учатся.
Ileader1=Меня никто не нанимает, это я нанимаю других! Можешь летать рядом и учиться вести дела.
IsOrderForAll=Это приказ по группе или лично мне?
LandingToObject=Совершаем посадку на <ObjectName>
MateBreak=Я был твоим партнером, но ты постоянно совершаешь действия, противоречащие моим принципам. Поэтому я отказываюсь от партнерства.
MateBreak1=Мне совсем не нравится быть твоим партнером. Ты не такой, каким показался мне вначале. Прощай.
MateRiot=Всё, с меня хватит! Больше я не намерен терпеть издевательства над собой. Наведи сначала порядок у себя в команде, а потом может быть и поговорим о партнерстве.
MateTheEnd=Дружище, срок нашего контракта закончился, и теперь я волен делать все, что захочу.
MateTheEnd1=Если ты забыл, срок контракта подошел к концу. Я честно выполнил свои обязательства.
MateTheEndLowLeadership=<Player>, я вынужден досрочно разорвать с тобой контракт. В нем четко прописана строка о том, что работодатель не имеет права обманывать работника - и что я вижу сейчас? Твои навыки лидерства оказывается далеко не так хороши, как мне казалось ранее. Развивайся, ходи на тренинги, познавай жизнь во всем ее многообразии и тогда, может быть, мы еще поработаем вместе.
MateTheEndLowLeadership1=Ты больше не можешь позволить себе иметь в подчинении такого крутого рейнджера, как я, <Player>. Поэтому я досрочно разрываю с тобой контракт. Без обид, это просто бизнес. Когда ты станешь настоящим лидером - я с удовольствием поработаю на тебя снова.
NeedLeadership=Ты не похож на лидера, <Ranger>. Морда лица у тебя слишком простая.
NeedLeadership=Советую тебе, <Ranger>, развить в начале навык лидерства, а то пока тебе просто бессмысленно заниматься поиском партнеров.
NeedLeadership1=Эй, ты, деревня, да у тебя есть хоть какие-то навыки лидерства? А, <Ranger>? Я буду служить только под началом великого рейнджера!
Ok=О'кей, я буду служить тебе <Month> мес. Обязуюсь всегда быть рядом и приходить на помощь в минуты опасности.
Ok=Только свистни, и мои крутые стволы в твоем распоряжении, <Ranger>.
Ok1=По рукам. Мой корабль в твоем распоряжении на <Month> мес.
Ok1=Я буду душой и телом с тобой, <Ranger>, в минуты горя и радости, пока смерть не разлучит нас. Ну, или пока не пройдет указанный в контракте срок.
OrderForAll=Это приказ всем! С каждым отдельно я общаться не намерен.
OrderForYou=Тебе, персонально. Конец связи.
PlayerDismissBad=Надоел ты мне своими выходками, видеть тебя не могу.
PlayerDismissGood=Ты хороший партнер, но со мной тебе оставаться будет опасно.
PlayerDismissNo=Ха-ха! Я пошутил!
PlayerDismissSend=Пора нам с тобой расстаться
PlayerLess=Установить сумму в 2 раза меньше
PlayerMore=Удвоить сумму
PlayerOk=Договорились
PlayerSend=Иди под мое командование, <Ranger>
PlayerSendDropCargo=Мы летим налегке. Тебе пора избавиться от лишнего груза.
PlayerSendDropCargo1=Дружище, давай выкидывай лишний груз. Я помогу тебе с перевозкой.
Send=Я готов выложить <Money> cr за то, чтобы ты стал моим партнером
Send1=Плачу <Money> cr, и ты идешь на меня работать
SmallMoney=Я отказываюсь. Мои услуги и время стоят гораздо больше...
SmallMoney1=Что? Ты хочешь купить меня за эти жалкие копейки?
SmallMoney2=Нет, я не буду работать за такие гроши!
Suspect=Я тебе не настолько доверяю, чтобы рассматривать предложение о партнерстве.
Suspect1=Ты слишком подозрительный тип. Не буду на тебя работать.
YouNeedInMoreRank=Извини, <Ranger>, но мое звание повыше твоего будет. Поэтому я не стану служить под твоим началом. Ты давно получал новые лычки на военной базе?
