AddDefGenerator=Добавить генератор защиты
AddRadar=Добавить радар
AddRepairRobot=Добавить дроида
AddScaner=Добавить сканер
AddWeapon=Добавить оружие
AddedEq=Добавлено: <PrevItem>
AddedNothing=Ничего не добавлено
Cancelled=Ладно, отменяем сборку. Но ты учти, что наши парни серьезно устали таскать детали со склада, поэтому смотри повнимательней, когда пешком ходишь.
CompletionText=Корабль успешно собран:
CompletionText=<FullName>
CompletionText=Пилот будет вашим партнером <CntMonth> месяцев
CompletionTextNotPartner=Корабль успешно собран:
CompletionTextNotPartner=<FullName>
InHold=<ItemName> в трюме, размер <Size>, <Stats>
InShop=<ItemName> в магазине, размер <Size>, <Stats>, цена <Cost> cr.
InStorage=<ItemName> на складе, размер <Size>, <Stats>
ItemList=Сейчас установлено:
ItemList=-----------------------
ItemList=<ItemList>-----------------------
ItemList=Общая стоимость <TotalCost>, места осталось <FreeSpace>.
NotAvailable=Нет слота
NotInstalled=Отсутствует
PickCargoHook=Выбери захват.
PickDefGenerator=Выбери генератор защиты.
PickEngine=Выбери двигатель.
PickFuelTanks=Выбери бак.
PickHull=Хорошо, приступим к сборке. Первым делом надо выбрать корпус.
PickRadar=Выбери радар.
PickRepairRobot=Выбери дроида
PickScaner=Выбери сканер.
PickWeapon=Выбери пушку.
PlayerSend=Я хочу собрать корабль одному из ваших пилотов
ReadyCanAddMore=С такой конфигурацией уже можно летать, но можно и добавить что-то из дополнительного оборудования.
ReadyCanNotAddMore=К такой конфигурации уже и добавить нечего. Собираем?
StatsCargoHook=дальность <Radius>, мощность <PickUpSize>
StatsDefGenerator=защита <Percent>%
StatsEngine=скорость <Speed>, прыжок <Parsec>
StatsFuelTanks=вместимость <Capacity>
StatsHull=броня <HitProtect>, получаемый урон Э:<FragilityE>% О:<FragilityS>% Р:<FragilityM>%
StatsRadar=дальность <Radius>
StatsRepairRobot=ремонт <RecoverHitPoints>
StatsScaner=мощность <Percent>
StatsSeries=серия <SeriesName>
StatsWeapon=дальность <Radius>, урон <MinDamage>-<MaxDamage>
WarningConfirm=Да, и так сойдет
WarningPirateCnt=<Player>, не забывай - ты можешь собрать корабль, но пилот не пойдет к тебе в подчинение. Твой текущий пиратский рейтинг просто не позволяет нормальным пацанам признаться, что они в подчинении у такого салаги! Кроме того, не забывай, что максимальное количество нанятых братков не может превышать <clr>4<clrEnd>. Ты все равно хочешь продолжить сборку?
cancel=Я передумал собирать вам корабль, оставлю деньги себе!
confirm=Собирай!
skip=Обойдемся без этого
weaponN=Пушка N
