AGENT=DATA\FormAchievements\Img\agent.gi
AGENTD=DATA\FormAchievements\Img\agent_grey.gi
ARCHEOLOGY=DATA\FormAchievements\Img\archeology.gi
ARCHEOLOGYD=DATA\FormAchievements\Img\archeology_grey.gi
ASTEROID=DATA\FormAchievements\Img\ASTEROID.gi
ASTEROIDD=DATA\FormAchievements\Img\ASTEROID_grey.gi
BARON=DATA\FormAchievements\Img\BARON.gi
BAROND=DATA\FormAchievements\Img\BARON_grey.gi
BERTORSLAYER=DATA\FormAchievements\Img\Kill50Bertors.gi
BERTORSLAYERD=DATA\FormAchievements\Img\Kill50Bertors_grey.gi
BEST=DATA\FormAchievements\Img\BEST.gi
BESTD=DATA\FormAchievements\Img\BEST_grey.gi
BLACKHEAD=DATA\FormAchievements\Img\balckhhead.gi
BLACKHEADD=DATA\FormAchievements\Img\balckhhead_grey.gi
BLAZERPIECE=DATA\FormAchievements\Img\BLAZERPIECE.gi
BLAZERPIECED=DATA\FormAchievements\Img\BLAZERPIECE_grey.gi
BLAZERPROGRAM=DATA\FormAchievements\Img\BLAZERPROGRAM.gi
BLAZERPROGRAMD=DATA\FormAchievements\Img\BLAZERPROGRAM_grey.gi
BLUEKILLS=DATA\FormAchievements\Img\Kill500Kellers.gi
BLUEKILLSD=DATA\FormAchievements\Img\Kill500Kellers_grey.gi
BOMBER=DATA\FormAchievements\Img\BOMBER.gi
BOMBERD=DATA\FormAchievements\Img\BOMBER_grey.gi
BREZHNEV=DATA\FormAchievements\Img\brezhnev.gi
BREZHNEVD=DATA\FormAchievements\Img\brezhnev_grey.gi
BUMMER=DATA\FormAchievements\Img\bummer.gi
BUMMERD=DATA\FormAchievements\Img\bummer_grey.gi
CHAMPION=DATA\FormAchievements\Img\champion.gi
CHAMPIOND=DATA\FormAchievements\Img\champion_grey.gi
COALLITION=DATA\FormAchievements\Img\COALLITION.gi
COALLITIOND=DATA\FormAchievements\Img\COALLITION_grey.gi
COMMANDOR=DATA\FormAchievements\Img\COMMANDOR.gi
COMMANDORD=DATA\FormAchievements\Img\COMMANDOR_grey.gi
CONTRABAND=DATA\FormAchievements\Img\CONTRABAND.gi
CONTRABANDD=DATA\FormAchievements\Img\CONTRABAND_grey.gi
COUNTERTERRORIST=DATA\FormAchievements\Img\KillPirateBases.gi
COUNTERTERRORISTD=DATA\FormAchievements\Img\KillPirateBases_grey.gi
CREDITOR=DATA\FormAchievements\Img\CREDITOR.gi
CREDITORD=DATA\FormAchievements\Img\CREDITOR_grey.gi
DEALER=DATA\FormAchievements\Img\DEALER.gi
DEALERD=DATA\FormAchievements\Img\DEALER_grey.gi
DEFENDER=DATA\FormAchievements\Img\DEFENDER.gi
DEFENDERD=DATA\FormAchievements\Img\DEFENDER_grey.gi
DELIVERY=DATA\FormAchievements\Img\Delivery50.gi
DELIVERYD=DATA\FormAchievements\Img\Delivery50_grey.gi
DOLGOZHID=DATA\FormAchievements\Img\dolgozhid.gi
DOLGOZHIDD=DATA\FormAchievements\Img\dolgozhid_grey.gi
DRAIN=DATA\FormAchievements\Img\SuckHealth.gi
DRAIND=DATA\FormAchievements\Img\SuckHealth_grey.gi
ENERGY=DATA\FormAchievements\Img\high_voltage.gi
ENERGYD=DATA\FormAchievements\Img\high_voltage_grey.gi
EXPLORER=DATA\FormAchievements\Img\100planets.gi
EXPLORERD=DATA\FormAchievements\Img\100planets_grey.gi
FRY=DATA\FormAchievements\Img\FRY.gi
FRYD=DATA\FormAchievements\Img\FRY_grey.gi
GIRLSHIRE=DATA\FormAchievements\Img\GIRLSHIRE.gi
GIRLSHIRED=DATA\FormAchievements\Img\GIRLSHIRE_grey.gi
GIRLSQUEST=DATA\FormAchievements\Img\GIRLSQUEST.gi
GIRLSQUESTD=DATA\FormAchievements\Img\GIRLSQUEST_grey.gi
GREENKILLS=DATA\FormAchievements\Img\Kill500Terrons.gi
GREENKILLSD=DATA\FormAchievements\Img\Kill500Terrons_grey.gi
GUARD=DATA\FormAchievements\Img\GUARD.gi
GUARDD=DATA\FormAchievements\Img\GUARD_grey.gi
HACKER=DATA\FormAchievements\Img\100programsuses.gi
HACKERD=DATA\FormAchievements\Img\100programsuses_grey.gi
HATER=DATA\FormAchievements\Img\HATER.gi
HATERD=DATA\FormAchievements\Img\HATER_grey.gi
HOLEMAN=DATA\FormAchievements\Img\holeman.gi
HOLEMAND=DATA\FormAchievements\Img\holeman_grey.gi
HOLEPEACE=DATA\FormAchievements\Img\HOLEPEACE.gi
HOLEPEACED=DATA\FormAchievements\Img\HOLEPEACE_grey.gi
HULL=DATA\FormAchievements\Img\HULL.gi
HULLD=DATA\FormAchievements\Img\HULL_grey.gi
ILL=DATA\FormAchievements\Img\ill.gi
ILLD=DATA\FormAchievements\Img\ill_grey.gi
INSURANCE=DATA\FormAchievements\Img\EndMoney.gi
INSURANCED=DATA\FormAchievements\Img\EndMoney_grey.gi
INVESTOR=DATA\FormAchievements\Img\deposit.gi
INVESTORD=DATA\FormAchievements\Img\deposit_grey.gi
IRONMAN=DATA\FormAchievements\Img\robot.gi
IRONMAND=DATA\FormAchievements\Img\robot_grey.gi
JUMPER=DATA\FormAchievements\Img\JUMPER.gi
JUMPERD=DATA\FormAchievements\Img\JUMPER_grey.gi
KELLERDESTROY=DATA\FormAchievements\Img\KELLERDESTROY.gi
KELLERDESTROYD=DATA\FormAchievements\Img\KELLERDESTROY_grey.gi
KELLERRESEARCH=DATA\FormAchievements\Img\KELLERRESEARCH.gi
KELLERRESEARCHD=DATA\FormAchievements\Img\KELLERRESEARCH_grey.gi
KIBERMAN=DATA\FormAchievements\Img\kiberman.gi
KIBERMAND=DATA\FormAchievements\Img\kiberman_grey.gi
MANYFACES=DATA\FormAchievements\Img\manyfaces.gi
MANYFACESD=DATA\FormAchievements\Img\manyfaces_grey.gi
MAPBUILDER=DATA\FormAchievements\Img\starmap.gi
MAPBUILDERD=DATA\FormAchievements\Img\starmap_grey.gi
MASTER=DATA\FormAchievements\Img\vjozhd.gi
MASTERD=DATA\FormAchievements\Img\vjozhd_grey.gi
MONEY=DATA\FormAchievements\Img\money.gi
MONEYD=DATA\FormAchievements\Img\money_grey.gi
NARKOMAN=DATA\FormAchievements\Img\narkoman.gi
NARKOMAND=DATA\FormAchievements\Img\narkoman_grey.gi
NEGOCIANT=DATA\FormAchievements\Img\NEGOCIANT.gi
NEGOCIANTD=DATA\FormAchievements\Img\NEGOCIANT_grey.gi
NODES=DATA\FormAchievements\Img\NODES.gi
NODESD=DATA\FormAchievements\Img\NODES_grey.gi
OLDFAG=DATA\FormAchievements\Img\oldfag.gi
OLDFAGD=DATA\FormAchievements\Img\oldfag_grey.gi
PEACELOVER=DATA\FormAchievements\Img\peacelover.gi
PEACELOVERD=DATA\FormAchievements\Img\peacelover_grey.gi
PIECECREATOR=DATA\FormAchievements\Img\piececreator.gi
PIECECREATORD=DATA\FormAchievements\Img\piececreator_grey.gi
PIRATE=DATA\FormAchievements\Img\PIRATE.gi
PIRATED=DATA\FormAchievements\Img\PIRATE_grey.gi
PIRATESYSTEMS=DATA\FormAchievements\Img\PIRATESYSTEMS.gi
PIRATESYSTEMSD=DATA\FormAchievements\Img\PIRATESYSTEMS_grey.gi
PIRATEWIN=DATA\FormAchievements\Img\PIRATEWIN.gi
PIRATEWIND=DATA\FormAchievements\Img\PIRATEWIN_grey.gi
POSTMAN=DATA\FormAchievements\Img\POSTMAN.gi
POSTMAND=DATA\FormAchievements\Img\POSTMAN_grey.gi
PRISON=DATA\FormAchievements\Img\prison.gi
PRISONBAIL=DATA\FormAchievements\Img\Jail.gi
PRISONBAILD=DATA\FormAchievements\Img\Jail_grey.gi
PRISOND=DATA\FormAchievements\Img\prison_grey.gi
QUEST=DATA\FormAchievements\Img\QUEST.gi
QUESTD=DATA\FormAchievements\Img\QUEST_grey.gi
RATING=DATA\FormAchievements\Img\RATING.gi
RATINGD=DATA\FormAchievements\Img\RATING_grey.gi
REDKILLS=DATA\FormAchievements\Img\Kill500Blazers.gi
REDKILLSD=DATA\FormAchievements\Img\Kill500Blazers_grey.gi
ROBBER=DATA\FormAchievements\Img\Robbery.gi
ROBBERD=DATA\FormAchievements\Img\Robbery_grey.gi
ROCKET=DATA\FormAchievements\Img\ROCKET.gi
ROCKETD=DATA\FormAchievements\Img\ROCKET_grey.gi
RUINS=DATA\FormAchievements\Img\RUINS.gi
RUINSD=DATA\FormAchievements\Img\RUINS_grey.gi
SCIENCE=DATA\FormAchievements\Img\SCIENCE.gi
SCIENCED=DATA\FormAchievements\Img\SCIENCE_grey.gi
SCRATCHDAMAGE=DATA\FormAchievements\Img\NotThroughArmor.gi
SCRATCHDAMAGED=DATA\FormAchievements\Img\NotThroughArmor_grey.gi
SHIELD=DATA\FormAchievements\Img\shield.gi
SHIELDD=DATA\FormAchievements\Img\shield_grey.gi
SHU=DATA\FormAchievements\Img\SHU.gi
SHUD=DATA\FormAchievements\Img\SHU_grey.gi
SIDECHANGER=DATA\FormAchievements\Img\SIDECHANGER.gi
SIDECHANGERD=DATA\FormAchievements\Img\SIDECHANGER_grey.gi
SKILL=DATA\FormAchievements\Img\SKILL.gi
SKILLD=DATA\FormAchievements\Img\SKILL_grey.gi
SPEED=DATA\FormAchievements\Img\speed.gi
SPEEDD=DATA\FormAchievements\Img\speed_grey.gi
SPLINTER=DATA\FormAchievements\Img\splinter.gi
SPLINTERD=DATA\FormAchievements\Img\splinter_grey.gi
SPRINTER=DATA\FormAchievements\Img\sprinter.gi
SPRINTERD=DATA\FormAchievements\Img\sprinter_grey.gi
SUNFUEL=DATA\FormAchievements\Img\StarReFuel.gi
SUNFUELD=DATA\FormAchievements\Img\StarReFuel_grey.gi
TERMINATOR=DATA\FormAchievements\Img\terminator.gi
TERMINATORD=DATA\FormAchievements\Img\terminator_grey.gi
TERRONBATTLE=DATA\FormAchievements\Img\TERRONBATTLE.gi
TERRONBATTLED=DATA\FormAchievements\Img\TERRONBATTLE_grey.gi
TERRONSTAR=DATA\FormAchievements\Img\TERRONSTAR.gi
TERRONSTARD=DATA\FormAchievements\Img\TERRONSTAR_grey.gi
TERRORIST=DATA\FormAchievements\Img\KillCoalitionBases.gi
TERRORISTD=DATA\FormAchievements\Img\KillCoalitionBases_grey.gi
TRANCLUCATORS=DATA\FormAchievements\Img\RobotsGlory.gi
TRANCLUCATORSD=DATA\FormAchievements\Img\RobotsGlory_grey.gi
WARRIORKILLS=DATA\FormAchievements\Img\Kill100Warriors.gi
WARRIORKILLSD=DATA\FormAchievements\Img\Kill100Warriors_grey.gi
