AddInfoAboutPartner=рейнджер <Name> до <Date>
BestPirate=Злейший пират
BestTrader=Выдающийся делец
BestWarrior=Отличившийся воин
Capital=Богатство
Caption=Рейтинг рейнджеров
Character=Характер
Dominator=Доминаторы
InPrisonName=Рейнджер <Name>
InPrisonText=Не имеет возможности исполнять рейнджерский долг. Отбывает срок в тюрьме на планете <Planet>.
Kill=Убил
KillAllShip=Всего
LiberationSystem=Освободил систем
Name=Имя
Number=N
Other=Другие
PartnerBossManyText=Обладает ярко выраженными лидерскими качествами. Под его руководством служат: <Names>.
PartnerBossOneText=Командует рейнджером <Name> до <Date>.
PartnerName=Рейнджер <Name>
PartnerText=Служит под руководством рейнджера <Name>. Контракт заканчивается <Date>.
PartnerTextDateEnd=Настало время уведомить босса о расторжении контракта.
Pirate=Пираты
PlayerName=Рейнджер <Name><br>- Игрок -
PlayerPartnerNo=Вы не имеете в подчинении других рейнджеров.
PlayerPartnerOk=У вас в подчинении: <Names>.
PlayerText=<PartnerInfo>
Points=Опыт
Race=Раса
Rank=Звание
Strength=Вооружение
